1111111111111111111111111111111111111111
1001010001000001000100000000000000000001
100001000000C010000010000101010100000001
100010000100C000000001001000010000000111
1000001010000110000100000110101000010011
10C0000000000000001010101000100010000011
10C1001001000010010000100000100001000101
1100000010000000110000101011000000C00001
1000100000000000010010000000000000000001
1000000100000001000000011010000000000001
1000100110001000000010010010000C00000001
1000100000010010000010000000101000000001
1000100000001111011010100001110001100001
1000000000000000000000001000000010000001
1000000000011010100000011000000000000101
10110C0100011000000000000000000011101001
10100000C1000100000000000010010010000001
10000000001000000111010110000001000000P1
10000000000010011001000C0000110010001011
1000000C00000100000000110001010001000001
1001010000000001C00001000001010100010001
1010000000000010110000110000000111000001
1110100001001000100100000001001010000101
110010001100000CC000001010100E1000000001
11000000000000000000000110100C0100010001
1000000000100000010001000000000000000001
1100100000000000000010001000000100110011
1101100000100010000000010100100000001001
10000C0000000100000111100100010000000001
1111111111111111111111111111111111111111
