1111111111111111111
1101000000011001001
1110110000000100001
1E100000000010C1001
10100011C0011000001
1000001000000000101
1001000000001000001
1000100000001001001
1000000000000000001
1011000000001000101
1110000001100000001
1110000001010100011
1000001000000001001
1100001000010011001
1100101000000100001
1100101111100001101
10000000010001100P1
1100000000000010011
1111111111111111111
