1111111111111111111111111111111111111111
1000000001000110100000011010010010000001
10000000100000101011010100001100010000C1
1000001010000001000000110001100100110101
100000000000000000000100010C100000000001
1001100101000000000000001000001000000101
1000110000000000000111010000010001000001
1110000000001001001000001101000C01100001
1000000010000000010000000000000000000001
1001011C10E00011010000001000100000100001
1000010000010000001000010110110100101101
100000011011000000001000P000100011000001
1000000000110011000110000000000000001001
1000000010001000000000001101100100000011
1010110100010000000001000100000000000001
1100000000010000000001000000000000000011
10000000000000011C0000000000000001000001
1000000110000000101000100010100000000011
1000001110000010000000100010000000001001
1000000000111101010001000000100000001001
1000000000100010001100100010000011000101
1000C00000100101000100010100000000000001
1001C00010011000000000010000000010010011
100C000000000000000010100110000000000001
1101C0010010100001000000010C000000001001
1000010000001110111000000000000100101001
1001111000100000100001000000010000000001
1001100000000000000001000000000001100101
1110000000000000001000100000100000000001
1111111111111111111111111111111111111111
