1111111111111111111
1000100000001010001
1100000100000000011
1001000000100000001
100110101C000100001
1100000000010111001
1001000000001000001
1000010000000100101
1001000000000000101
1000000000001000001
1000001011100000001
1010000010010100001
1000000000110001001
1110010100000000001
1001000000000110001
1000000010001011101
100E0010000P1001001
1000100011010001001
1111111111111111111
